0000000000
0011110000
0001111000
0000000000
0012101210
0000000000
0010101010
0020200000
0000000000
0000000000